0000000000000000000000
0000000000000000000000
0000000000000000000000
1110001111000000000000
1110001111000000001111
1110001111000000000000
0000011111000110000000
0000000000000100000000
0000000000011100000000
0010000000000100000000
0000000001100100100100
0000000000000100144100
0000111000000010111111
0000010000000010111122
0000010000000010111122
1111111111111111111122
